After,0000,ds,6,1,0,7
After,0000,ds-preopt,6,1,0,7
After,0000,simpl,14,5,0,19
After,0010,ds,1076,1849,211,3136
After,0010,ds-preopt,1153,1998,112,3263
After,0010,simpl,1185,1981,383,3549
After,0020,ds,1916,3439,361,5716
After,0020,ds-preopt,2043,3688,192,5923
After,0020,simpl,2095,3651,673,6419
After,0030,ds,2756,5029,511,8296
After,0030,ds-preopt,2933,5378,272,8583
After,0030,simpl,3005,5321,963,9289
After,0040,ds,3596,6619,661,10876
After,0040,ds-preopt,3823,7068,352,11243
After,0040,simpl,3915,6991,1253,12159
After,0050,ds,4436,8209,811,13456
After,0050,ds-preopt,4713,8758,432,13903
After,0050,simpl,4825,8661,1543,15029
After,0060,ds,5276,9799,961,16036
After,0060,ds-preopt,5603,10448,512,16563
After,0060,simpl,5735,10331,1833,17899
After,0070,ds,6116,11389,1111,18616
After,0070,ds-preopt,6493,12138,592,19223
After,0070,simpl,6645,12001,2123,20769
After,0080,ds,6956,12979,1261,21196
After,0080,ds-preopt,7383,13828,672,21883
After,0080,simpl,7555,13671,2413,23639
After,0090,ds,7796,14569,1411,23776
After,0090,ds-preopt,8273,15518,752,24543
After,0090,simpl,8465,15341,2703,26509
After,0100,ds,8636,16159,1561,26356
After,0100,ds-preopt,9163,17208,832,27203
After,0100,simpl,9375,17011,2993,29379
After,0200,ds,17036,32059,3061,52156
After,0200,ds-preopt,18063,34108,1632,53803
After,0200,simpl,18475,33711,5893,58079
After,0300,ds,25436,47959,4561,77956
After,0300,ds-preopt,26963,51008,2432,80403
After,0300,simpl,27575,50411,8793,86779
After,0400,ds,33836,63859,6061,103756
After,0400,ds-preopt,35863,67908,3232,107003
After,0400,simpl,36675,67111,11693,115479
After,0500,ds,42236,79759,7561,129556
After,0500,ds-preopt,44763,84808,4032,133603
After,0500,simpl,45775,83811,14593,144179
After,0600,ds,50636,95659,9061,155356
After,0600,ds-preopt,53663,101708,4832,160203
After,0600,simpl,54875,100511,17493,172879
After,0700,ds,59036,111559,10561,181156
After,0700,ds-preopt,62563,118608,5632,186803
After,0700,simpl,63975,117211,20393,201579
After,0800,ds,67436,127459,12061,206956
After,0800,ds-preopt,71463,135508,6432,213403
After,0800,simpl,73075,133911,23293,230279
After,0900,ds,75836,143359,13561,232756
After,0900,ds-preopt,80363,152408,7232,240003
After,0900,simpl,82175,150611,26193,258979
After,1000,ds,84236,159259,15061,258556
After,1000,ds-preopt,89263,169308,8032,266603
After,1000,simpl,91275,167311,29093,287679
Applicative,000,ds,6,1,0,7
Applicative,000,ds-preopt,6,1,0,7
Applicative,000,simpl,14,5,0,19
Applicative,010,ds,85,197,0,282
Applicative,010,ds-preopt,107,219,0,326
Applicative,010,simpl,93,201,0,294
Applicative,020,ds,155,557,0,712
Applicative,020,ds-preopt,197,599,0,796
Applicative,020,simpl,163,561,0,724
Applicative,030,ds,225,1117,0,1342
Applicative,030,ds-preopt,287,1179,0,1466
Applicative,030,simpl,233,1121,0,1354
Applicative,040,ds,295,1877,0,2172
Applicative,040,ds-preopt,377,1959,0,2336
Applicative,040,simpl,303,1881,0,2184
Applicative,050,ds,365,2837,0,3202
Applicative,050,ds-preopt,467,2939,0,3406
Applicative,050,simpl,373,2841,0,3214
Applicative,060,ds,435,3997,0,4432
Applicative,060,ds-preopt,557,4119,0,4676
Applicative,060,simpl,443,4001,0,4444
Applicative,070,ds,505,5357,0,5862
Applicative,070,ds-preopt,647,5499,0,6146
Applicative,070,simpl,513,5361,0,5874
Applicative,080,ds,575,6917,0,7492
Applicative,080,ds-preopt,737,7079,0,7816
Applicative,080,simpl,583,6921,0,7504
Applicative,090,ds,645,8677,0,9322
Applicative,090,ds-preopt,827,8859,0,9686
Applicative,090,simpl,653,8681,0,9334
Applicative,100,ds,715,10637,0,11352
Applicative,100,ds-preopt,917,10839,0,11756
Applicative,100,simpl,723,10641,0,11364
Before,000,ds,6,1,0,7
Before,000,ds-preopt,6,1,0,7
Before,000,simpl,14,5,0,19
Before,010,ds,1234,7569,892,9695
Before,010,ds-preopt,1534,9446,610,11590
Before,010,simpl,1275,7918,1148,10341
Before,020,ds,2474,21869,2052,26395
Before,020,ds-preopt,3014,26961,1100,31075
Before,020,simpl,2545,23378,2988,28911
Before,030,ds,3914,43369,3612,50895
Before,030,ds-preopt,4694,53176,1590,59460
Before,030,simpl,4015,46838,5628,56481
Before,040,ds,5554,72069,5572,83195
Before,040,ds-preopt,6574,88091,2080,96745
Before,040,simpl,5685,78298,9068,93051
Before,050,ds,7394,107969,7932,123295
Before,050,ds-preopt,8654,131706,2570,142930
Before,050,simpl,7555,117758,13308,138621
Before,060,ds,9434,151069,10692,171195
Before,060,ds-preopt,10934,184021,3060,198015
Before,060,simpl,9625,165218,18348,193191
Before,070,ds,11674,201369,13852,226895
Before,070,ds-preopt,13414,245036,3550,262000
Before,070,simpl,11895,220678,24188,256761
Before,080,ds,14114,258869,17412,290395
Before,080,ds-preopt,16094,314751,4040,334885
Before,080,simpl,14365,284138,30828,329331
Before,090,ds,16754,323569,21372,361695
Before,090,ds-preopt,18974,393166,4530,416670
Before,090,simpl,17035,355598,38268,410901
Before,100,ds,19594,395469,25732,440795
Before,100,ds-preopt,22054,480281,5020,507355
Before,100,simpl,19905,435058,46508,501471
ConstraintFamily_Deep,000,ds,6,1,0,7
ConstraintFamily_Deep,000,ds-preopt,6,1,0,7
ConstraintFamily_Deep,000,simpl,14,5,0,19
ConstraintFamily_Deep,010,ds,22,147,153,322
ConstraintFamily_Deep,010,ds-preopt,32,176,662,870
ConstraintFamily_Deep,010,simpl,30,151,153,334
ConstraintFamily_Deep,020,ds,38,415,293,746
ConstraintFamily_Deep,020,ds-preopt,56,468,2390,2914
ConstraintFamily_Deep,020,simpl,46,419,293,758
ConstraintFamily_Deep,030,ds,66,870,448,1384
ConstraintFamily_Deep,030,ds-preopt,98,950,5197,6245
ConstraintFamily_Deep,030,simpl,74,874,448,1396
ConstraintFamily_Deep,040,ds,70,1091,573,1734
ConstraintFamily_Deep,040,ds-preopt,104,1192,8715,10011
ConstraintFamily_Deep,040,simpl,78,1095,573,1746
ConstraintFamily_Deep,050,ds,82,1430,708,2220
ConstraintFamily_Deep,050,ds-preopt,122,1554,13220,14896
ConstraintFamily_Deep,050,simpl,90,1434,708,2232
ConstraintFamily_Deep,060,ds,122,2140,878,3140
ConstraintFamily_Deep,060,ds-preopt,182,2294,18965,21441
ConstraintFamily_Deep,060,simpl,130,2144,878,3152
ConstraintFamily_Deep,070,ds,134,2507,1013,3654
ConstraintFamily_Deep,070,ds-preopt,200,2684,25355,28239
ConstraintFamily_Deep,070,simpl,142,2511,1013,3666
ConstraintFamily_Deep,080,ds,134,2727,1133,3994
ConstraintFamily_Deep,080,ds-preopt,200,2924,32514,35638
ConstraintFamily_Deep,080,simpl,142,2731,1133,4006
ConstraintFamily_Deep,090,ds,134,2947,1253,4334
ConstraintFamily_Deep,090,ds-preopt,200,3164,40561,43925
ConstraintFamily_Deep,090,simpl,142,2951,1253,4346
ConstraintFamily_Deep,100,ds,154,3472,1398,5024
ConstraintFamily_Deep,100,ds-preopt,230,3714,49756,53700
ConstraintFamily_Deep,100,simpl,162,3476,1398,5036
ConstraintFamily_Shallow,000,ds,6,1,0,7
ConstraintFamily_Shallow,000,ds-preopt,6,1,0,7
ConstraintFamily_Shallow,000,simpl,14,5,0,19
ConstraintFamily_Shallow,010,ds,25,254,152,431
ConstraintFamily_Shallow,010,ds-preopt,37,338,152,527
ConstraintFamily_Shallow,010,simpl,33,258,152,443
ConstraintFamily_Shallow,020,ds,41,622,292,955
ConstraintFamily_Shallow,020,ds-preopt,61,780,292,1133
ConstraintFamily_Shallow,020,simpl,49,626,292,967
ConstraintFamily_Shallow,030,ds,69,1177,447,1693
ConstraintFamily_Shallow,030,ds-preopt,103,1412,447,1962
ConstraintFamily_Shallow,030,simpl,77,1181,447,1705
ConstraintFamily_Shallow,040,ds,73,1498,572,2143
ConstraintFamily_Shallow,040,ds-preopt,109,1804,572,2485
ConstraintFamily_Shallow,040,simpl,81,1502,572,2155
ConstraintFamily_Shallow,050,ds,85,1937,707,2729
ConstraintFamily_Shallow,050,ds-preopt,127,2316,707,3150
ConstraintFamily_Shallow,050,simpl,93,1941,707,2741
ConstraintFamily_Shallow,060,ds,125,2747,877,3749
ConstraintFamily_Shallow,060,ds-preopt,187,3206,877,4270
ConstraintFamily_Shallow,060,simpl,133,2751,877,3761
ConstraintFamily_Shallow,070,ds,137,3214,1012,4363
ConstraintFamily_Shallow,070,ds-preopt,205,3746,1012,4963
ConstraintFamily_Shallow,070,simpl,145,3218,1012,4375
ConstraintFamily_Shallow,080,ds,137,3534,1132,4803
ConstraintFamily_Shallow,080,ds-preopt,205,4136,1132,5473
ConstraintFamily_Shallow,080,simpl,145,3538,1132,4815
ConstraintFamily_Shallow,090,ds,137,3854,1252,5243
ConstraintFamily_Shallow,090,ds-preopt,205,4526,1252,5983
ConstraintFamily_Shallow,090,simpl,145,3858,1252,5255
ConstraintFamily_Shallow,100,ds,157,4479,1397,6033
ConstraintFamily_Shallow,100,ds-preopt,235,5226,1397,6858
ConstraintFamily_Shallow,100,simpl,165,4483,1397,6045
Generics_LR,000,ds,6,1,0,7
Generics_LR,000,ds-preopt,6,1,0,7
Generics_LR,000,simpl,14,5,0,19
Generics_LR,010,ds,166,737,354,1257
Generics_LR,010,ds-preopt,212,925,344,1481
Generics_LR,010,simpl,174,741,334,1249
Generics_LR,020,ds,324,1715,684,2723
Generics_LR,020,ds-preopt,410,2073,664,3147
Generics_LR,020,simpl,332,1719,644,2695
Generics_LR,030,ds,518,3121,1044,4683
Generics_LR,030,ds-preopt,644,3649,1014,5307
Generics_LR,030,simpl,526,3125,984,4635
Generics_LR,040,ds,640,3951,1344,5935
Generics_LR,040,ds-preopt,806,4649,1304,6759
Generics_LR,040,simpl,648,3955,1264,5867
Generics_LR,050,ds,786,5053,1664,7503
Generics_LR,050,ds-preopt,992,5921,1614,8527
Generics_LR,050,simpl,794,5057,1564,7415
Generics_LR,060,ds,1016,7023,2054,10093
Generics_LR,060,ds-preopt,1262,8061,1994,11317
Generics_LR,060,simpl,1024,7027,1934,9985
Generics_LR,070,ds,1162,8181,2374,11717
Generics_LR,070,ds-preopt,1448,9389,2304,13141
Generics_LR,070,simpl,1170,8185,2234,11589
Generics_LR,080,ds,1272,8991,2664,12927
Generics_LR,080,ds-preopt,1598,10369,2584,14551
Generics_LR,080,simpl,1280,8995,2504,12779
Generics_LR,090,ds,1382,9801,2954,14137
Generics_LR,090,ds-preopt,1748,11349,2864,15961
Generics_LR,090,simpl,1390,9805,2774,13969
Generics_LR,100,ds,1552,11311,3294,16157
Generics_LR,100,ds-preopt,1958,13029,3194,18181
Generics_LR,100,simpl,1560,11315,3094,15969
Generics_SOP,000,ds,6,1,0,7
Generics_SOP,000,ds-preopt,6,1,0,7
Generics_SOP,000,simpl,14,5,0,19
Generics_SOP,010,ds,248,3105,965,4318
Generics_SOP,010,ds-preopt,288,3395,975,4658
Generics_SOP,010,simpl,256,3109,965,4330
Generics_SOP,020,ds,478,10555,2905,13938
Generics_SOP,020,ds-preopt,538,11075,2925,14538
Generics_SOP,020,simpl,486,10559,2905,13950
Generics_SOP,030,ds,708,22405,5845,28958
Generics_SOP,030,ds-preopt,788,23155,5875,29818
Generics_SOP,030,simpl,716,22409,5845,28970
Generics_SOP,040,ds,938,38655,9785,49378
Generics_SOP,040,ds-preopt,1038,39635,9825,50498
Generics_SOP,040,simpl,946,38659,9785,49390
Generics_SOP,050,ds,1168,59305,14725,75198
Generics_SOP,050,ds-preopt,1288,60515,14775,76578
Generics_SOP,050,simpl,1176,59309,14725,75210
Generics_SOP,060,ds,1398,84355,20665,106418
Generics_SOP,060,ds-preopt,1538,85795,20725,108058
Generics_SOP,060,simpl,1406,84359,20665,106430
Generics_SOP,070,ds,1628,113805,27605,143038
Generics_SOP,070,ds-preopt,1788,115475,27675,144938
Generics_SOP,070,simpl,1636,113809,27605,143050
Generics_SOP,080,ds,1858,147655,35545,185058
Generics_SOP,080,ds-preopt,2038,149555,35625,187218
Generics_SOP,080,simpl,1866,147659,35545,185070
Generics_SOP,090,ds,2088,185905,44485,232478
Generics_SOP,090,ds-preopt,2288,188035,44575,234898
Generics_SOP,090,simpl,2096,185909,44485,232490
Generics_SOP,100,ds,2318,228555,54425,285298
Generics_SOP,100,ds-preopt,2538,230915,54525,287978
Generics_SOP,100,simpl,2326,228559,54425,285310
HasNormalForm,000,ds,6,1,0,7
HasNormalForm,000,ds-preopt,6,1,0,7
HasNormalForm,000,simpl,14,5,0,19
HasNormalForm,010,ds,8,2,0,10
HasNormalForm,010,ds-preopt,16,25,1520,1561
HasNormalForm,010,simpl,16,6,0,22
HasNormalForm,020,ds,8,2,0,10
HasNormalForm,020,ds-preopt,16,25,5420,5461
HasNormalForm,020,simpl,16,6,0,22
HasNormalForm,030,ds,8,2,0,10
HasNormalForm,030,ds-preopt,16,25,11720,11761
HasNormalForm,030,simpl,16,6,0,22
HasNormalForm,040,ds,8,2,0,10
HasNormalForm,040,ds-preopt,16,25,20420,20461
HasNormalForm,040,simpl,16,6,0,22
HasNormalForm,050,ds,8,2,0,10
HasNormalForm,050,ds-preopt,16,25,31520,31561
HasNormalForm,050,simpl,16,6,0,22
HasNormalForm,060,ds,8,2,0,10
HasNormalForm,060,ds-preopt,16,25,45020,45061
HasNormalForm,060,simpl,16,6,0,22
HasNormalForm,070,ds,8,2,0,10
HasNormalForm,070,ds-preopt,16,25,60920,60961
HasNormalForm,070,simpl,16,6,0,22
HasNormalForm,080,ds,8,2,0,10
HasNormalForm,080,ds-preopt,16,25,79220,79261
HasNormalForm,080,simpl,16,6,0,22
HasNormalForm,090,ds,8,2,0,10
HasNormalForm,090,ds-preopt,16,25,99920,99961
HasNormalForm,090,simpl,16,6,0,22
HasNormalForm,100,ds,8,2,0,10
HasNormalForm,100,ds-preopt,16,25,123020,123061
HasNormalForm,100,simpl,16,6,0,22
HigherKinded,000,ds,6,1,0,7
HigherKinded,000,ds-preopt,6,1,0,7
HigherKinded,000,simpl,14,5,0,19
HigherKinded,010,ds,1233,2639,245,4117
HigherKinded,010,ds-preopt,1291,2803,128,4222
HigherKinded,010,simpl,1364,2786,470,4620
HigherKinded,020,ds,2203,4889,415,7507
HigherKinded,020,ds-preopt,2291,5143,218,7652
HigherKinded,020,simpl,2424,5136,830,8390
HigherKinded,030,ds,3173,7139,585,10897
HigherKinded,030,ds-preopt,3291,7483,308,11082
HigherKinded,030,simpl,3484,7486,1190,12160
HigherKinded,040,ds,4143,9389,755,14287
HigherKinded,040,ds-preopt,4291,9823,398,14512
HigherKinded,040,simpl,4544,9836,1550,15930
HigherKinded,050,ds,5113,11639,925,17677
HigherKinded,050,ds-preopt,5291,12163,488,17942
HigherKinded,050,simpl,5604,12186,1910,19700
HigherKinded,060,ds,6083,13889,1095,21067
HigherKinded,060,ds-preopt,6291,14503,578,21372
HigherKinded,060,simpl,6664,14536,2270,23470
HigherKinded,070,ds,7053,16139,1265,24457
HigherKinded,070,ds-preopt,7291,16843,668,24802
HigherKinded,070,simpl,7724,16886,2630,27240
HigherKinded,080,ds,8023,18389,1435,27847
HigherKinded,080,ds-preopt,8291,19183,758,28232
HigherKinded,080,simpl,8784,19236,2990,31010
HigherKinded,090,ds,8993,20639,1605,31237
HigherKinded,090,ds-preopt,9291,21523,848,31662
HigherKinded,090,simpl,9844,21586,3350,34780
HigherKinded,100,ds,9963,22889,1775,34627
HigherKinded,100,ds-preopt,10291,23863,938,35092
HigherKinded,100,simpl,10904,23936,3710,38550
Induction_List,000,ds,6,1,0,7
Induction_List,000,ds-preopt,6,1,0,7
Induction_List,000,simpl,14,5,0,19
Induction_List,010,ds,38,543,0,581
Induction_List,010,ds-preopt,42,549,0,591
Induction_List,010,simpl,46,547,0,593
Induction_List,020,ds,68,2083,0,2151
Induction_List,020,ds-preopt,72,2089,0,2161
Induction_List,020,simpl,76,2087,0,2163
Induction_List,030,ds,98,4623,0,4721
Induction_List,030,ds-preopt,102,4629,0,4731
Induction_List,030,simpl,106,4627,0,4733
Induction_List,040,ds,128,8163,0,8291
Induction_List,040,ds-preopt,132,8169,0,8301
Induction_List,040,simpl,136,8167,0,8303
Induction_List,050,ds,158,12703,0,12861
Induction_List,050,ds-preopt,162,12709,0,12871
Induction_List,050,simpl,166,12707,0,12873
Induction_List,060,ds,188,18243,0,18431
Induction_List,060,ds-preopt,192,18249,0,18441
Induction_List,060,simpl,196,18247,0,18443
Induction_List,070,ds,218,24783,0,25001
Induction_List,070,ds-preopt,222,24789,0,25011
Induction_List,070,simpl,226,24787,0,25013
Induction_List,080,ds,248,32323,0,32571
Induction_List,080,ds-preopt,252,32329,0,32581
Induction_List,080,simpl,256,32327,0,32583
Induction_List,090,ds,278,40863,0,41141
Induction_List,090,ds-preopt,282,40869,0,41151
Induction_List,090,simpl,286,40867,0,41153
Induction_List,100,ds,308,50403,0,50711
Induction_List,100,ds-preopt,312,50409,0,50721
Induction_List,100,simpl,316,50407,0,50723
Induction_Tree_Nominal,000,ds,6,1,0,7
Induction_Tree_Nominal,000,ds-preopt,6,1,0,7
Induction_Tree_Nominal,000,simpl,14,5,0,19
Induction_Tree_Nominal,010,ds,22,146,591,759
Induction_Tree_Nominal,010,ds-preopt,32,175,604,811
Induction_Tree_Nominal,010,simpl,30,150,591,771
Induction_Tree_Nominal,020,ds,38,414,2240,2692
Induction_Tree_Nominal,020,ds-preopt,56,467,2282,2805
Induction_Tree_Nominal,020,simpl,46,418,2240,2704
Induction_Tree_Nominal,030,ds,66,869,4960,5895
Induction_Tree_Nominal,030,ds-preopt,98,949,5039,6086
Induction_Tree_Nominal,030,simpl,74,873,4960,5907
Induction_Tree_Nominal,040,ds,70,1090,8388,9548
Induction_Tree_Nominal,040,ds-preopt,104,1191,8507,9802
Induction_Tree_Nominal,040,simpl,78,1094,8388,9560
Induction_Tree_Nominal,050,ds,82,1429,12800,14311
Induction_Tree_Nominal,050,ds-preopt,122,1553,12962,14637
Induction_Tree_Nominal,050,simpl,90,1433,12800,14323
Induction_Tree_Nominal,060,ds,122,2139,18445,20706
Induction_Tree_Nominal,060,ds-preopt,182,2293,18657,21132
Induction_Tree_Nominal,060,simpl,130,2143,18445,20718
Induction_Tree_Nominal,070,ds,134,2506,24735,27375
Induction_Tree_Nominal,070,ds-preopt,200,2683,24997,27880
Induction_Tree_Nominal,070,simpl,142,2510,24735,27387
Induction_Tree_Nominal,080,ds,134,2726,31794,34654
Induction_Tree_Nominal,080,ds-preopt,200,2923,32106,35229
Induction_Tree_Nominal,080,simpl,142,2730,31794,34666
Induction_Tree_Nominal,090,ds,134,2946,39741,42821
Induction_Tree_Nominal,090,ds-preopt,200,3163,40103,43466
Induction_Tree_Nominal,090,simpl,142,2950,39741,42833
Induction_Tree_Nominal,100,ds,154,3471,48831,52456
Induction_Tree_Nominal,100,ds-preopt,230,3713,49248,53191
Induction_Tree_Nominal,100,simpl,162,3475,48831,52468
Induction_Tree_Phantom,000,ds,6,1,0,7
Induction_Tree_Phantom,000,ds-preopt,6,1,0,7
Induction_Tree_Phantom,000,simpl,14,5,0,19
Induction_Tree_Phantom,010,ds,22,146,96,264
Induction_Tree_Phantom,010,ds-preopt,32,175,96,303
Induction_Tree_Phantom,010,simpl,30,150,96,276
Induction_Tree_Phantom,020,ds,38,414,186,638
Induction_Tree_Phantom,020,ds-preopt,56,467,186,709
Induction_Tree_Phantom,020,simpl,46,418,186,650
Induction_Tree_Phantom,030,ds,66,869,291,1226
Induction_Tree_Phantom,030,ds-preopt,98,949,291,1338
Induction_Tree_Phantom,030,simpl,74,873,291,1238
Induction_Tree_Phantom,040,ds,70,1090,366,1526
Induction_Tree_Phantom,040,ds-preopt,104,1191,366,1661
Induction_Tree_Phantom,040,simpl,78,1094,366,1538
Induction_Tree_Phantom,050,ds,82,1429,451,1962
Induction_Tree_Phantom,050,ds-preopt,122,1553,451,2126
Induction_Tree_Phantom,050,simpl,90,1433,451,1974
Induction_Tree_Phantom,060,ds,122,2139,571,2832
Induction_Tree_Phantom,060,ds-preopt,182,2293,571,3046
Induction_Tree_Phantom,060,simpl,130,2143,571,2844
Induction_Tree_Phantom,070,ds,134,2506,656,3296
Induction_Tree_Phantom,070,ds-preopt,200,2683,656,3539
Induction_Tree_Phantom,070,simpl,142,2510,656,3308
Induction_Tree_Phantom,080,ds,134,2726,726,3586
Induction_Tree_Phantom,080,ds-preopt,200,2923,726,3849
Induction_Tree_Phantom,080,simpl,142,2730,726,3598
Induction_Tree_Phantom,090,ds,134,2946,796,3876
Induction_Tree_Phantom,090,ds-preopt,200,3163,796,4159
Induction_Tree_Phantom,090,simpl,142,2950,796,3888
Induction_Tree_Phantom,100,ds,154,3471,891,4516
Induction_Tree_Phantom,100,ds-preopt,230,3713,891,4834
Induction_Tree_Phantom,100,simpl,162,3475,891,4528
PatternSynonym_Default,000,ds,6,1,0,7
PatternSynonym_Default,000,ds-preopt,6,1,0,7
PatternSynonym_Default,000,simpl,14,5,0,19
PatternSynonym_Default,010,ds,280,497,11,788
PatternSynonym_Default,010,ds-preopt,306,540,11,857
PatternSynonym_Default,010,simpl,142,603,4,749
PatternSynonym_Default,020,ds,716,1457,11,2184
PatternSynonym_Default,020,ds-preopt,762,1542,11,2315
PatternSynonym_Default,020,simpl,648,1383,4,2035
PatternSynonym_Default,030,ds,1349,2772,11,4132
PatternSynonym_Default,030,ds-preopt,1415,2898,11,4324
PatternSynonym_Default,030,simpl,1241,2658,4,3903
PatternSynonym_Default,040,ds,2182,4487,11,6680
PatternSynonym_Default,040,ds-preopt,2268,4654,11,6933
PatternSynonym_Default,040,simpl,2034,4333,4,6371
PatternSynonym_Default,050,ds,3215,6602,11,9828
PatternSynonym_Default,050,ds-preopt,3321,6810,11,10142
PatternSynonym_Default,050,simpl,3027,6408,4,9439
PatternSynonym_Default,060,ds,4448,9117,11,13576
PatternSynonym_Default,060,ds-preopt,4574,9366,11,13951
PatternSynonym_Default,060,simpl,4220,8883,4,13107
PatternSynonym_Default,070,ds,5881,12032,11,17924
PatternSynonym_Default,070,ds-preopt,6027,12322,11,18360
PatternSynonym_Default,070,simpl,5613,11758,4,17375
PatternSynonym_Default,080,ds,7514,15347,11,22872
PatternSynonym_Default,080,ds-preopt,7680,15678,11,23369
PatternSynonym_Default,080,simpl,7206,15033,4,22243
PatternSynonym_Default,090,ds,9347,19062,11,28420
PatternSynonym_Default,090,ds-preopt,9533,19434,11,28978
PatternSynonym_Default,090,simpl,8999,18708,4,27711
PatternSynonym_Default,100,ds,11380,23177,11,34568
PatternSynonym_Default,100,ds-preopt,11586,23590,11,35187
PatternSynonym_Default,100,simpl,10992,22783,4,33779
PatternSynonym_NFS,000,ds,6,1,0,7
PatternSynonym_NFS,000,ds-preopt,6,1,0,7
PatternSynonym_NFS,000,simpl,14,5,0,19
PatternSynonym_NFS,010,ds,280,497,11,788
PatternSynonym_NFS,010,ds-preopt,306,540,11,857
PatternSynonym_NFS,010,simpl,142,603,4,749
PatternSynonym_NFS,020,ds,716,1457,11,2184
PatternSynonym_NFS,020,ds-preopt,762,1542,11,2315
PatternSynonym_NFS,020,simpl,648,1383,4,2035
PatternSynonym_NFS,030,ds,1349,2772,11,4132
PatternSynonym_NFS,030,ds-preopt,1415,2898,11,4324
PatternSynonym_NFS,030,simpl,1241,2658,4,3903
PatternSynonym_NFS,040,ds,2182,4487,11,6680
PatternSynonym_NFS,040,ds-preopt,2268,4654,11,6933
PatternSynonym_NFS,040,simpl,2034,4333,4,6371
PatternSynonym_NFS,050,ds,3215,6602,11,9828
PatternSynonym_NFS,050,ds-preopt,3321,6810,11,10142
PatternSynonym_NFS,050,simpl,3027,6408,4,9439
PatternSynonym_NFS,060,ds,4448,9117,11,13576
PatternSynonym_NFS,060,ds-preopt,4574,9366,11,13951
PatternSynonym_NFS,060,simpl,4220,8883,4,13107
PatternSynonym_NFS,070,ds,5881,12032,11,17924
PatternSynonym_NFS,070,ds-preopt,6027,12322,11,18360
PatternSynonym_NFS,070,simpl,5613,11758,4,17375
PatternSynonym_NFS,080,ds,7514,15347,11,22872
PatternSynonym_NFS,080,ds-preopt,7680,15678,11,23369
PatternSynonym_NFS,080,simpl,7206,15033,4,22243
PatternSynonym_NFS,090,ds,9347,19062,11,28420
PatternSynonym_NFS,090,ds-preopt,9533,19434,11,28978
PatternSynonym_NFS,090,simpl,8999,18708,4,27711
PatternSynonym_NFS,100,ds,11380,23177,11,34568
PatternSynonym_NFS,100,ds-preopt,11586,23590,11,35187
PatternSynonym_NFS,100,simpl,10992,22783,4,33779
PreEval_Nominal,000,ds,6,1,0,7
PreEval_Nominal,000,ds-preopt,6,1,0,7
PreEval_Nominal,000,simpl,14,5,0,19
PreEval_Nominal,010,ds,22,146,23,191
PreEval_Nominal,010,ds-preopt,32,175,23,230
PreEval_Nominal,010,simpl,30,150,23,203
PreEval_Nominal,020,ds,38,414,43,495
PreEval_Nominal,020,ds-preopt,56,467,43,566
PreEval_Nominal,020,simpl,46,418,43,507
PreEval_Nominal,030,ds,66,869,63,998
PreEval_Nominal,030,ds-preopt,98,949,63,1110
PreEval_Nominal,030,simpl,74,873,63,1010
PreEval_Nominal,040,ds,70,1090,83,1243
PreEval_Nominal,040,ds-preopt,104,1191,83,1378
PreEval_Nominal,040,simpl,78,1094,83,1255
PreEval_Nominal,050,ds,82,1429,103,1614
PreEval_Nominal,050,ds-preopt,122,1553,103,1778
PreEval_Nominal,050,simpl,90,1433,103,1626
PreEval_Nominal,060,ds,122,2139,123,2384
PreEval_Nominal,060,ds-preopt,182,2293,123,2598
PreEval_Nominal,060,simpl,130,2143,123,2396
PreEval_Nominal,070,ds,134,2506,143,2783
PreEval_Nominal,070,ds-preopt,200,2683,143,3026
PreEval_Nominal,070,simpl,142,2510,143,2795
PreEval_Nominal,080,ds,134,2726,163,3023
PreEval_Nominal,080,ds-preopt,200,2923,163,3286
PreEval_Nominal,080,simpl,142,2730,163,3035
PreEval_Nominal,090,ds,134,2946,183,3263
PreEval_Nominal,090,ds-preopt,200,3163,183,3546
PreEval_Nominal,090,simpl,142,2950,183,3275
PreEval_Nominal,100,ds,154,3471,203,3828
PreEval_Nominal,100,ds-preopt,230,3713,203,4146
PreEval_Nominal,100,simpl,162,3475,203,3840
PreEval_Phantom,000,ds,6,1,0,7
PreEval_Phantom,000,ds-preopt,6,1,0,7
PreEval_Phantom,000,simpl,14,5,0,19
PreEval_Phantom,010,ds,22,146,82,250
PreEval_Phantom,010,ds-preopt,32,175,82,289
PreEval_Phantom,010,simpl,30,150,82,262
PreEval_Phantom,020,ds,38,414,158,610
PreEval_Phantom,020,ds-preopt,56,467,158,681
PreEval_Phantom,020,simpl,46,418,158,622
PreEval_Phantom,030,ds,66,869,246,1181
PreEval_Phantom,030,ds-preopt,98,949,246,1293
PreEval_Phantom,030,simpl,74,873,246,1193
PreEval_Phantom,040,ds,70,1090,310,1470
PreEval_Phantom,040,ds-preopt,104,1191,310,1605
PreEval_Phantom,040,simpl,78,1094,310,1482
PreEval_Phantom,050,ds,82,1429,382,1893
PreEval_Phantom,050,ds-preopt,122,1553,382,2057
PreEval_Phantom,050,simpl,90,1433,382,1905
PreEval_Phantom,060,ds,122,2139,482,2743
PreEval_Phantom,060,ds-preopt,182,2293,482,2957
PreEval_Phantom,060,simpl,130,2143,482,2755
PreEval_Phantom,070,ds,134,2506,554,3194
PreEval_Phantom,070,ds-preopt,200,2683,554,3437
PreEval_Phantom,070,simpl,142,2510,554,3206
PreEval_Phantom,080,ds,134,2726,614,3474
PreEval_Phantom,080,ds-preopt,200,2923,614,3737
PreEval_Phantom,080,simpl,142,2730,614,3486
PreEval_Phantom,090,ds,134,2946,674,3754
PreEval_Phantom,090,ds-preopt,200,3163,674,4037
PreEval_Phantom,090,simpl,142,2950,674,3766
PreEval_Phantom,100,ds,154,3471,754,4379
PreEval_Phantom,100,ds-preopt,230,3713,754,4697
PreEval_Phantom,100,simpl,162,3475,754,4391
SimpleRecord,000,ds,6,1,0,7
SimpleRecord,000,ds-preopt,6,1,0,7
SimpleRecord,000,simpl,14,5,0,19
SimpleRecord,010,ds,228,305,0,533
SimpleRecord,010,ds-preopt,248,325,0,573
SimpleRecord,010,simpl,284,343,0,627
SimpleRecord,020,ds,428,1005,0,1433
SimpleRecord,020,ds-preopt,468,1045,0,1513
SimpleRecord,020,simpl,524,1073,0,1597
SimpleRecord,030,ds,628,2105,0,2733
SimpleRecord,030,ds-preopt,688,2165,0,2853
SimpleRecord,030,simpl,764,2203,0,2967
SimpleRecord,040,ds,828,3605,0,4433
SimpleRecord,040,ds-preopt,908,3685,0,4593
SimpleRecord,040,simpl,1004,3733,0,4737
SimpleRecord,050,ds,1028,5505,0,6533
SimpleRecord,050,ds-preopt,1128,5605,0,6733
SimpleRecord,050,simpl,1244,5663,0,6907
SimpleRecord,060,ds,1228,7805,0,9033
SimpleRecord,060,ds-preopt,1348,7925,0,9273
SimpleRecord,060,simpl,1484,7993,0,9477
SimpleRecord,070,ds,1428,10505,0,11933
SimpleRecord,070,ds-preopt,1568,10645,0,12213
SimpleRecord,070,simpl,1724,10723,0,12447
SimpleRecord,080,ds,1628,13605,0,15233
SimpleRecord,080,ds-preopt,1788,13765,0,15553
SimpleRecord,080,simpl,1964,13853,0,15817
SimpleRecord,090,ds,1828,17105,0,18933
SimpleRecord,090,ds-preopt,2008,17285,0,19293
SimpleRecord,090,simpl,2204,17383,0,19587
SimpleRecord,100,ds,2028,21005,0,23033
SimpleRecord,100,ds-preopt,2228,21205,0,23433
SimpleRecord,100,simpl,2444,21313,0,23757
Superclasses,000,ds,6,1,0,7
Superclasses,000,ds-preopt,6,1,0,7
Superclasses,000,simpl,14,5,0,19
Superclasses,010,ds,264,94,0,358
Superclasses,010,ds-preopt,264,94,0,358
Superclasses,010,simpl,409,518,0,927
Superclasses,020,ds,464,174,0,638
Superclasses,020,ds-preopt,464,174,0,638
Superclasses,020,simpl,729,1608,0,2337
Superclasses,030,ds,664,254,0,918
Superclasses,030,ds-preopt,664,254,0,918
Superclasses,030,simpl,1049,3298,0,4347
Superclasses,040,ds,864,334,0,1198
Superclasses,040,ds-preopt,864,334,0,1198
Superclasses,040,simpl,1369,5588,0,6957
Superclasses,050,ds,1064,414,0,1478
Superclasses,050,ds-preopt,1064,414,0,1478
Superclasses,050,simpl,1689,8478,0,10167
Superclasses,060,ds,1264,494,0,1758
Superclasses,060,ds-preopt,1264,494,0,1758
Superclasses,060,simpl,2009,11968,0,13977
Superclasses,070,ds,1464,574,0,2038
Superclasses,070,ds-preopt,1464,574,0,2038
Superclasses,070,simpl,2329,16058,0,18387
Superclasses,080,ds,1664,654,0,2318
Superclasses,080,ds-preopt,1664,654,0,2318
Superclasses,080,simpl,2649,20748,0,23397
Superclasses,090,ds,1864,734,0,2598
Superclasses,090,ds-preopt,1864,734,0,2598
Superclasses,090,simpl,2969,26038,0,29007
Superclasses,100,ds,2064,814,0,2878
Superclasses,100,ds-preopt,2064,814,0,2878
Superclasses,100,simpl,3289,31928,0,35217
